8 8 
10001101 
10100001 
10111001 
10001010 
11100010 
11010010 
00010010 
11010000 
1 
3 
1 1 4 3 4 4 